NNNNNNNNG
NNNNNNNNN
NNNNNNNNN
NBBBBBBBH
NNNNNNNNN
NNNSNNNNN
